Описание классов.

Item - Общий класс заявка. Содержит общие поля и методы для всех заявок. От него наследуются классы для различных видов заявок.
	Поля:
	id - уникальный номер заявки
	name - имя заявки
	description - описание заявки
	comments -  массив комментариев содержит объекты типа Comment. Т.е. одна заявка может содержать много комментариев
	createDate - дата создания заявки
	Методы:
	getId - возвращает id заявки
	setId - устанавливет id заявки
	addComment(Comment comment) - добавляет новый комментарий в заявку

Наследники Request. Реализуют особенности различных видов заявок. Предполагаю, что разные виды заявок нужно будет обрабатыавть по разному.
	Task - заявка задача.
	Bug - заявка об ошибке.

Comment - класс комментарий к заявке. Комментарий со временем может обрасти доп. полями и методами, поэтому в отдельный класс.
    Поля:
    id - уникальный номер комментария
    commentText - текст комментария

Tracker - класс, содержащий все заявки и обеспечивающий работу с ними, как со множеством. 
	Поля:
	items - массив всех заявок, объекты типа Item
	Методы:
	addItem(Item item) - Добавляет новую заявку
	editItem(Item item, String name, String descr) - редактирование заявки, переданной заявке устанавливается имя и описание.
	deleteItem(Item item) - Удаляет заявку,
	getListAllItems() - Формирует список всех заявок.
	addItemsComment(Item item, String commentText) - добавляет комментарий к заявке.

Display - Запускающий класс. Визуализация и взаимодействие с пользователем. Отображает необходимую информацию, обрабатыает ввод от пользователя.
	Поля:
	tracker - объект, который визуализируем
	Методы:
	main() - старт программы
	displayListItems() - показать список заявок
	getActiveFromUsers() - показать меню действий, получить выбор пользователя.
